###############################################
#@............................................#
#.............................................#
#.............................................#
#.............................................#
#.............................................#
#.............................................#
#.............................................#
#.............................................#
#.............................................#
#.............................................#
#.............................................#
#.............................................#
###############################################